111111111111111111
1P0000000000111001
101111110000100001
100000010C01011111
1011110100010000C1
100000000001111101
100C0011000000E001
111111111111111111
